#############################################################
#                                                           #
#                                                           #
#                                                           #
#                                                           #
#                                                           #
#                                                           #
#                                                           #
#                                                           #
#                                                           #
#                            >                              #
#                                                           #
#                                                           #
#                                                           #
#                                                           #
#                                                           #
#                                                           #
#                                                           #
#                                                           #
#                                                           #
#############################################################