#############################################################
#                                                           #
#                                                           #
#                                                           #
#                                                           #
#                                                           #
#     #################################################     #
                                                             
                                                             
                                                             
                             >                                
                                                             
                                                             
                                                             
#     #################################################     #
#                                                           #
#                                                           #
#                                                           #
#                                                           #
#                                                           #
#############################################################